####################################################################################################
#S#                 #       #       # #         # #     #     #                 #       #     #   ##
# ##### ########### # ##### # # ### # # ##### # # # # # ### # # ############# ### ### # # ### # # ##
# #   #   #     #   # #     # # #   #   #   # # #   # # #   # #     #   #     #   # # #   #   # # ##
# # # ### # ##### ### # ####### # ### ##### # # ##### # # ### ##### # # # ##### ### # ##### ### # ##
#   #     # #     #   #         #   # #     # #       # # #         # #   #     #   # #     #   # ##
########### # ##### ############### # # ##### ######### # ##### ########### ##### # # # ##### ### ##
#     #       # #     # #           # # #   # #         #   #   #       #         # # #       # # ##
# # # # ####### # ### # # ########### # # # # # ########### # ### ##### # ########### ######### # ##
# # # # #       # #   #   #             # #   #     #       # # #   # #   #     #     #     #   # ##
# # # # ##### ### # ##### # ############# ######### ### # ### # ### # ##### ### # ####### # # # # ##
# # # # #   #     #     # # # #           #       #   # # #   #   #   #     # #   #       # # #   ##
# # # # # # # ######### # # # # ########### ##### ### # # # ##### ### # ##### ######### ### # ######
# # # #   # #       # # # #   #   #     #   #   # #   # # #       #   #   #   # #       #   # #   ##
### # ##### ####### # # # ##### # ##### # ##### # # ### # ######### ##### # # # # # ##### ### # # ##
#   # #     # #     # # #     # #   #   #     # #   #   # #         #   # # #   # #   #   #   # # ##
# ### # ##### # ##### # ##### # ### # ####### # ######### # ######### # # # # ### ### # ### ### # ##
#   # #     #         # #   # # #   #       # #         # #   #       # # # # #   #   # #   #   # ##
# # ####### # ######### # # # ### ### ### # # # # ##### # ### ### ####### # ### ### ### # ### ### ##
# #   #     # #     #   # # # #   # #   # # # # #     #     # #   #       # #     # # # # #   #   ##
# ### # ##### # ### # ### ### # ### ### # # # ### ### ####### # ### ####### # ##### # # # # ##### ##
# #   # #   # # #   # #         #   #   # # #   #   # #       # #   #   #   # #   # #   # # #   # ##
# # ### # # ### # ### ########### ### ### # ### ### # # ####### # ### # ### # # # # ##### # # # # ##
# #   #   #     # #   #     #   #     #   # # #   # # #   #     # #   #   #   # #   #     #   # # ##
##### ########### # # # ### # # ##### # ### # ### ### ### ##### # # ##### # ### ##### ##### ### # ##
#     #         # # # #   # # #     # # # # #   #   # #         #   #   # # # #       #     #   # ##
# ### # # ####### # ### ### # ##### ### # # ### ### # # ########### # ### # # ######### ##### ### ##
# # # # # #       # #   #   #   # # #   #       #   # # #     #   #   #   #   #       #     # #   ##
# # # # ### ####### # ### ### # # # # ### ####### ### # # ### # # ##### ##### ##### # ####### ### ##
# #   # #   #   #     #   #   # #     #   #   #   #     #   # # # #     # #   #   # #       #   # ##
# # ### # ### # ####### ### ### ####### ### # # ####### ### # # # # ##### # ### # # ####### ### ####
# #     # #   #   #     # # # #   #   # #   # # #     # #   # # # # #     # #   #   #     #   #   ##
# # ##### # ##### # ##### # # ### # # # # ### # ### # # # ### # # # # ### # ### ####### # ### ### ##
# # #   # # #   #   #     # # #   # # # # # #   #   # # # # # # #   # #   # #   #       #   #   # ##
# ### # # # ### ##### ##### # # ### # ### # ##### ### ### # # # ##### ### # # ### ####### ##### # ##
# #   #   #   # #         # # #     #     #     #   # #   #   # #   #   # #   #         # #     # ##
# # ######### # # ####### # # ############# ### ### # # ### ### # ### # ####### ####### ### ##### ##
#             #         #                   #       #   #       #     #               #          E##
####################################################################################################
####################################################################################################
