####################################################################################################
#S#    .............#.......#  .....# #      ...# #  ...#     #                 #    ...#.....#...##
#.#####.###########.#.#####.# #.###.# # #####.#.# # #.#.### # # ############# ### ###.#.#.###.#.#.##
#.#...#...#     #...#.#.....# #.#...#   #   #.#.#   #.#.#   # #     #   #     #   # #.#...#...#.#.##
#.#.#.###.# #####.###.#.#######.#.### ##### #.#.#####.#.# ### ##### # # # ##### ### #.#####.###.#.##
#...#.....# #.....#...#.........#...# #     #.#.......#.# #         # #   #     #   #.#.....#...#.##
########### #.#####.###############.# # #####.#########.# ##### ########### ##### # #.#.#####.###.##
#     #.......# #  ...# #...........# # #...#.#.........#   #   #       #         # #.#.......# #.##
# # # #.####### # ###.# #.########### # #.#.#.#.########### # ### ##### # ###########.######### #.##
# # # #.#       # #...#  .#             #.#...#.....#       # # #   # #   #.....#.....#     #...#.##
# # # #.##### ### #.#####.# #############.#########.### # ### # ### # #####.###.#.####### # #.#.#.##
# # # #.#...#     #.....#.# # #...........#.......#...# # #   #   #   #.....# #...#       # #.#...##
# # # #.#.#.# #########.#.# # #.###########.#####.###.# # # ##### ### #.##### ######### ### #.######
# # # #...#.#       # #.#.#   #...#     #...#   #.#...# # #       #   #...#   # #...    #   #.#   ##
### # #####.####### # #.#.##### #.##### #.##### #.#.### # ######### #####.# # # #.#.##### ###.# # ##
#   # #.....# #     # #.#.....# #...#   #.....# #...#   # #         #   #.# #   #.#...#   #...# # ##
# ### #.##### # ##### #.#####.# ###.# #######.# ######### # ######### # #.# # ###.###.# ###.### # ##
#   # #.....#         #.#   #.# #...#       #.#         # #   #       # #.# # #...#...# #...#   # ##
# # #######.# #########.# # #.###.### ### # #.# # ##### # ### ### #######.# ###.###.### #.### ### ##
# #   #.....# #.....#...# # #.#...# #   # # #.# #     #     # #   #.......# #...  #.# # #.#   #   ##
# ### #.##### #.###.#.### ###.#.### ### # # #.### ### ####### # ###.####### #.#####.# # #.# ##### ##
# #   #.#...# #.#...#.#      ...#   #   # # #...#   # #       # #...#...#   #.#...#.#   #.# #   # ##
# # ###.#.#.###.#.###.########### ### ### # ###.### # # ####### #.###.#.### #.#.#.#.#####.# # # # ##
# #   #...#.....#.#...#.....#   #     #   # # #...# # #   #     #.#...#...#...#.#...#.....#   # # ##
##### ###########.#.# #.###.# # ##### # ### # ###.### ### ##### #.#.#####.#.###.#####.##### ### # ##
#     #         #.#.# #.  #.# #     # # # # #   #...# #         #...#   #.#.# #.......#     #   # ##
# ### # # #######.#.###.###.# ##### ### # # ### ###.# # ########### # ###.#.# ######### ##### ### ##
# # # # # #.......#.#...#...#...# # #   #       #...# # #.....#...#   #...#...#    ...#     # #   ##
# # # # ###.#######.#.###.###.#.# # # ### #######.### # #.###.#.#.#####.#####.#####.#.####### ### ##
# #   # #...#...#  ...#...#...#.#     #   #...#...#     #...#.#.#.#.....# #...#...#.#.......#   # ##
# # ### #.###.#.#######.###.###.####### ###.#.#.####### ###.#.#.#.#.##### #.###.#.#.#######.### ####
# #     #.#...#...#.....# #.# #...#...# #...#.#.#  ...# #...#.#.#.#.#     #.#  .#...#     #...#   ##
# # #####.#.#####.#.##### #.# ###.#.#.# #.###.#.###.#.# #.###.#.#.#.# ### #.###.####### # ###.### ##
# # #...#.#.#   #...#     #.# #...#.#.# #.# #...#...#.# #.# #.#.#...# #   #.#...#       #   #...# ##
# ###.#.#.#.### ##### #####.# #.###.#.###.# #####.###.###.# #.#.##### ### #.#.### ####### #####.# ##
# #...#...#...# #         #.# #.....#.....#.....#...#.#...#...#.#   #   # #...#         # #.....# ##
# #.#########.# # ####### #.# #############.###.###.#.#.###.###.# ### # ####### ####### ###.##### ##
#  ...........#         #  .................#  .....#...#  .....#     #               #    ......E##
####################################################################################################
####################################################################################################