####################################################################################################
#S#    .........#       #           #   #.....#       #     #   #           #       # #         # ##
#.### #.#######.# ####### ### ##### # # #.# #.### ### # ### # # # ##### # ### # ### # # # ##### # ##
#...# #...#   #.........#   # #       # #.# #...#   #   #   # #     #   # #   #   #   # # #   #   ##
# #.#####.# # # #######.# ### ###########.# ###.####### # # # ####### ##### ##### ### # # # # ######
# #.#.....  # # #     #.....  #...........# # #.......# # # #   #     #     #     #   # #   #     ##
# #.#.##### # # # ### #####.# #.########### # #######.### ### ### # ### ##### ######### ####### # ##
# #...#   # #   # # #     #.# #.#   #   #   #     #...#   #   #   # #   #   # #     #     #   # # ##
# ##### # # ##### # ##### #.###.# # # ### ##### # #.### ### ### # ### ### # # # ### # ##### # ### ##
#     # #   #   # #     # #.....  #   #   #     # #...# #   # # # #   # # #   # # #     #   #   # ##
# ### # ##### # # # ### # ############# ##### ### ###.# # ### # ### ### # ##### # ####### ##### # ##
#   # #   #   #   # # # #             #     # #   #...# #     #     #   #   #   #   # #   #   #   ##
# # # ### # # ##### # # ############# # ### # #####.### ##### ######### ### # ### # # # ### # ### ##
# # #   # # #     #   #       #     # #   # #.......#       #         #   #   #   # # # #   #   # ##
# # ##### # ##### ### # ##### # ### # ### # #.####### # ############# ### ####### # # # # ##### # ##
# #       #     # # # # #   #   # # #   # # #.#     # #             #       #     #   #       # # ##
# ### ########### # # # # # ##### # ### # # #.# ##### ############# ####### ### ############# # ####
# #               # # #   # #     # #   # # #.#             #.....#       # #   #     #   #   #   ##
# ######### ####### # ##### ### # # # ##### #.# #############.###.### # ### # # # ### # # ### ### ##
#     #     #       #   # #   # #   # #     #.# # #...........# #...# #       # #   #   #   # #   ##
##### # ##### ##### ### # ### ##### # ### ###.# # #.########### ###.########### ### ####### # # # ##
#       #   #   # #   #     #     # #     # #.#   #...#           #...........#   # #     # # # # ##
# # ####### ### # ### ##### ##### # ####### #.### ###.### ### # #############.# ### # ### # # # ####
# #           # #   #     #     # #       #...#     #...#   # # #         #...# #   # #   # # #   ##
# ####### ### # # # # ### ### ### #########.####### ###.# ### # # ### ### #.##### ### ##### ##### ##
# # #     # # # # # #   # #   #   #   #...#...#...#   #.# #   # # # #   # #.#     # #     #     # ##
# # # ##### # # # ##### # # ### ### # #.#.###.#.#.### #.# # ### # # ### # #.# ##### # ### ##### # ##
#   # # #     # #   #   # #   #   # #...#...#...#.#   #.# #   # #     # # #.# #   #   #     # # # ##
### # # # ##### ### # ### ### ### # #.#####.#####.#####.# ### # ### ### # #.# # ### ### ### # # # ##
# # # # # #   #   # # #     # # # # #.#.....#.....#.....#   # #   # #   # #.  # #   # #   #   #   ##
# # # # # # # ### # # ##### # # # # #.#.#####.#####.####### # ##### # #####.### # ### ### ####### ##
#   # # #   # #   # #     # #   #   #.#.......#.....#     # #     # #      .#...#   #...#       # ##
# ### # # ##### ### ##### ##### #####.#########.##### # ### ##### # #######.#.#.### #.#.##### ### ##
#   # #   #     #       #     # #    ...........  #   #   # #     # #     #...#...  #.#.....#     ##
##### ##### ######### # ### # # ################# ####### # # ### # ##### #######.###.#####.##### ##
#     #   #   #     # #   # # #     #     #     #       #   #   # #   #   #     #.....    #.#...# ##
# ##### # ### # ### ##### # ####### # ### # ### ####### # ##### ##### # # ### # ######### #.#.#.# ##
#       #       #         #           #     #           #     #         #     #           #...#..E##
####################################################################################################
####################################################################################################