####################################################################################################
#S#  .....#         #       #        .....#    .........#.....#  .....#  ...#...#  ...........#   ##
#.# #.###.##### ### # ##### # #######.###.### #.#######.#.###.###.###.###.#.#.#.###.#########.### ##
#.# #.# #.....#   # #     #   #.....#.# #...# #.#   #...#.# #.....# #.....#.#.#.....#       #...# ##
#.###.# #####.### # ##### #####.###.#.# ###.###.# ###.###.# ####### #######.#.####### #########.# ##
#.#...#   #...#   # #       #...#...#.#    .....#   #...#.# #             #...# #...#.....#.....# ##
#.#.##### #.### ##### #######.###.###.########### # ###.#.# # ######### # ##### #.#.#.###.#.##### ##
#...#     #.# #   #   #   #...# #...#.......#     #   #...#     #...#   #       #.#.#...#...#...# ##
##### ### #.# # # # ##### #.### ###.# #####.####### # ### #######.#.# ######### #.#.###.#####.#.# ##
#.......# #.# # # # #     #.#.......#     #.#.....# #   # #.......#.#.........# #.#.....#  ...#.# ##
#.#####.###.# # # # # ### #.#.########### #.#.###.# ### # #.#######.#.#######.# #.####### #.###.# ##
#.....#.....#   #   #   # #.#...#.......# #...#...#   #   #...#   #.#.#...#...# #.#.....# #...#.# ##
#####.########### ##### # #.###.#.#####.# #####.#############.# # #.#.#.#.#.#####.#.###.#####.#.# ##
#.....#  ...#...#       # #.# #.#...#...# #   #.....#.......#.# # #.#...#.#.....#.#.#  .......#.# ##
#.##### #.#.#.#.######### #.# #.###.#.### ### #####.#.#####.#.# ###.#####.#####.#.#.###########.# ##
#.#   # #.#.#.#.....#   # #.# #.#...#...#   #     #...#   #.#...#...#   #...# #...#...# #...#...# ##
#.# # # #.#.#.#####.# ### #.# #.#.#####.### ##### ##### # #.###.#.### # ###.# #######.# #.#.#.### ##
#.# #   #.#...#.....#     #.#...#.#   #.#       #     # # #.....#.# # #    .#  .......# #.#.#...# ##
#.# #####.#####.####### ###.#.###.# # #.####### # ### ### #######.# # #####.###.####### #.#.###.# ##
#.# # #...#...#...#...# #...#.....# # #.....# # # #         #   #.#   #...#.....#   #.....#.....# ##
#.# # #.# #.#.###.#.#.# #.######### #######.# # # ######### # # #.#####.#.####### # #.########### ##
#.#   #.# #.#...#...#.# #.# #.....#.....  #.#   # #     #   # # #.......#...#   # # #...#      ...##
#.### #.###.###.#####.###.# #.###.#.###.# #.### # # ### # ### # ###########.# # # # ###.#######.#.##
#...# #.....# #.....#.....# #.# #...# #.# #...# #     # #     #         #...# #   #   #.#.......#.##
###.# ####### #####.####### #.# ##### #.# ###.# ##### # ### ########### #.##### ##### #.#.#######.##
# #.#             #.#       #.........#.#   #.#   #   # #   #...#.....# #.#...# #     #...#.....#.##
# #.##### #########.####### #########.#.### #.### # ### #####.#.#.###.# #.#.#.### #########.###.#.##
# #...#   #.......#.#     #   #     #.#...# #.# # #   # #.....#...# #.# #...#...#         #.# #...##
# ###.#####.#####.#.# ### # ### # # #.###.###.# # ##### #.######### #.##### ###.# ####### #.# ######
# #...#.....#   #...# #     #   # # #...#.....#   #     #...#...#   #.#...#   #.#       # #.#.....##
# #.###.##### # ##### ####### ### # ###.####### ### ##### #.#.#.### #.#.#.#####.######### #.#.###.##
#...#...#     #       #         # # # #.#     #   # #...# #...#.#   #...#...#...#         #.#.#...##
#.###.####### ### ##### ######### # # #.# # ##### # #.#.### ###.# #########.#.### ####### #.#.#.####
#.#...#       #   #   #   #       #   #.# #   #     #.#...#   #.# #       #...#       #   #...#...##
#.#.##### ######### # ### # ###########.# ### # #####.###.#####.# # # ### ##### ##### ###########.##
#.#.....#   #     # #   # # #         #.#   #   #...#.# #.#.....#   #   # #     #   #     #     #.##
#.#####.# # # ### # # ### # # ####### #.#########.#.#.# #.#.##### ##### ### ####### ##### # ### #.##
#.......# #     #   #     #         #  ...........#...#  ...#         #                 #     #  E##
####################################################################################################
####################################################################################################