####################################################################################################
#S   ##### ##   #    #      ##   # # #  #         #   # ## #   #             # #   ## #  ### #    ##
#     #    ### #    ##  # #        #  ##### # ## #####    ##    ##     ##    ## ##   #    # ##  #  #
####    # ##   # # ###   ##   # #    ##        ## #   ###  #      #     ##  #  #    ##   # # #     #
#        # ####### # # #  # #    # #     # #####  #    #   ##   # #  ###      ##     # #  # ##  #  #
##    #       #   #  #  # # #   #   #  # #   #      #       #  ##    #  #      # #  ##      #   ####
## #  #   #      #  ###  # ##   #  ## #  #   ## #     #  #   ##     # ###    #          # #  #     #
# ####     ##      #          ### # #     # ## #     #     # #   #      #       ###  ##   #  #     #
####  #       #    ##   ##     #   #         #     # #      # ##  #  #  ##   ### #   # #    ##   # #
# ###     #  # #     #   # #     # ## #                       #   #  # # #          ### # # # ## ###
# # #      # ###   ### ## #           # ##            #  # #  # ##  ##  # ###    #  ##  # ## # # # #
# #  ####       #    #     ###      # #    #      #   ## ##       # #   # ##  #     ##  #     #   ##
##  # # #    # # #       #    ##  ##  ###       ##  #         #    ## #    #    #  ## #    # # # ###
# #   #  #   ### ### # #   #   #      #   ## #    #           # #  #   #         #   #             #
# ##     #   ##   #   #  #  ####   #  ##  ####      ##      # # #  #  #     #  # #  #    # #       #
#    #       #   #    #   #     #   ## #    #           ## ### #  #    # # #  #   #   #########    #
#  #       #  ####     #      # ##     # #   #   # #  ## #  #  ##    # ####  ##   # ## #  #        #
## ### #      #  ### # #          ### # #   #  #   # ##       ## #  ##  #        # # #     #  ##   #
# # #### #  #  #    # ###         # ##      ##  #     #   #  #  #               #  #     ##  ##    #
##      #    #             ##     # ##          #           # #  # ##### ##  #  #  #   # ###  #    #
#    #     #    ###         #    ### #    # #       ###    #     #       # #  ##  ## # #  # ##  #  #
#   #         #  ## #### #  #     # #  # #      ## # ##  ##   ##         ####              # #  #  #
##   #   #  # #   ### #      #  # ##  ##   # #  # # #   #    #    #   #  ##  # #   #  #  # # # ##  #
# # #   #  ### # #    #    ## #    ##    # #       #  ##  ##         #        # #      # ### ##    #
# # ##    ##  #   # #  ##   ##   #         #    ###   #  #        # ## # #    ##     #    ##  ## # #
# ## ###   # #   ####  ##   #  ##  ## #####    #   ###  # ##  #     # ## ##     # # # #   #        #
#  #   ### ###     #     #     #     #   # #     #       # ##   ##      #    #      #      ##      #
#    #   ##     #     #      # # #  #            #   #    ##       #   #   #     ## ###   ##       #
#   # #      # #      # #  ## #  # #     ####    #        #   #             ## # ##   ####    ##  ##
# #         ##               #      ##              #     #  # #   ##    #     #      # ##      #  #
# ## ###    # # #        ##    # ##    #       #  ###  #   ## ### #  #  ##  # ###  #      ##  ##   #
#      #   #   #  # ###     #  ##     #       ##     ##  ##  # #        #    #     #       #  #   ##
#   #   #  # #  #     #      # # #         #### #   # ##  #     #       #     #  #                ##
# #  #     ## #   # #      ##  #  # #    #  #  #       #####         #     # ## #   #  ##    ##    #
# ##        #    #  #  # ##     #              ###          #  # ###   #         # #  ###   ##   # #
#   #     #   ##  #      #           ## #   # # #   #     # # ##   #  #              ##### #   #   #
## #    #  #  #         ###      ## # # #   #### #   ##    ###   ##   # #    ##     #    ### # # ###
# #  #  #  ## # # # # # ##    #   #  ####     #   ## #  ##   ##       #      ## # ##   # ##   #  E##
# # #  ##     #  #     # ##  #   #   #   #     # #    ## #  #  # #   # #   #   #     #  ##  #      #
####################################################################################################