####################################################################################################
#S ## ##### #     #    ##  ## #  ##        # #     #   # ## #    #       #   #        #       ## # #
#   #  # ##  #      # #    # #        # ##    #   #    ##        #  ##  #   #    #      #  ###     #
#               # # ##  # #   ###  #  ##     # #  #      ##  #             ##  #  #   # ###        #
# #    #    # #         #  #     #      #  ##      #   ##   #  # #          ## # #     ###### # ####
#  ##   #  #    #        #      ##                # ##   #  ##  #   ####        # ##  ### # #  ##  #
#     #  ## #   ######   # #    #  # ### # # #   ##  # ##        #      #   ##        #            #
#       #    # ##         #   # # #            #       #   #####  # #    ## #   #   ## #   # ###   #
#                     #  # ##   #  # ## #    ##              #      #  ### #    #      #    # #    #
## #    #  #     # ##       ###        ## ##      #     #       #  #  #  ###  # ##  # ## #      ####
#  #   ##    # #       # #        ##    #           #           # ###    ###  ##  #       ##  #    #
## ##  # # #      #          ## ##   ##  # #     ##  #   #  # #   #   #   ##    # ##  ## #   #   # #
#  #  #  # ## #  ##      #  # # ## #      ##  #    ####      #   #   ##  #   # # ###   ##      ##  #
#   #   #  # ##      #          # ## #    #   #             #  # ##   # # #  # #      ##  #     ## #
#    ###     #   #  # #   # #   #  # #       ##      #   #       ###     ###   ##   # # ##  ###    #
#  ### # # #  #  #   # ## #    #          #####  ##   #      #  #  #  # #    ###   ##         #    #
#   #    #  #         #   ##        # ###  ## #  ### #      #  # #  #  ##     ##     ###  # # # # ##
##   #   #         ###   #      #  ##    #     # #  #     # #  #  ###  #   ######         #   # #  #
##  #  ##    #  # # #  #   #     #  ##     ##  ##  #  #   ##  #  #        #   #          #         #
#   ## # #           #     #   # #  ##       #   ##  #### #   #  #####        ##  # #     ###    ###
#     # # #                 #  ## #     #  #  #          #  #     #                   #         #  #
#   ## #  #   #         #    ##      #    #  ##  #    #   # # # ## #   #      #      # #       # # #
#         #  # #    # ##     #  #   # #          # #    #   # ## ##    #   #      ###       ##    ##
#    # ###         #### #   # #  #  #    ##       ##  ## #   #    ### # #          #      #    #   #
##    # #         ##   ##       ## # ###   #    # # # # ##      #    #  # #     ###  ##      # ##  #
####   # #    #   #    ###    # # #     # # #         #       #   ## #  ##  ## #    #### #   #  ## #
#     #    #      ###   ##    ##      #      # ###    #    #      #     #   #  # #         #  #    #
# ##   #   #  #  ###  #   ## # #      # #   #   #  ##  ##     #     ####   ### # #    #  #   #     #
###    #    ##  #     ###  #       #  #     ## #    ## #   #    #   ##   # #    #    # # ## #   #  #
#      #          ##  #  # # ##    #     #    #            #             ###  ##      #   #    # # #
#   #      # #         ##  #    #    #   #    #  ##      #  #  #    # #    ##### #  #  #   #   #   #
#   #   #   # # ####   #   ##   ##  #    #     #   # #    ## # ###      ##      # #   ##  #    #   #
#      #  ##   ##   # #  # #  #   #    #  ##   ####           #    #      #   # ###  # ##      #   #
## #   # # #    ## ## #      ##           #  # #       #   #    ##  #  ## ## ##  #     #         # #
#  ##     ### #            # #   #  # ##  #    #  #    #       # #        #     # #  ## #     # #  #
#     #  #    #  #        #  #    ##   # #     #   #    #  #  ##   #  #    # ## # #       #    # # #
# #   ## # ### # #     #       ##  ## #           ## # #   ##  ##      # # ### # ##   ##   # #     #
#    #  ##    # #  #  ####  ####   #   #     #         #### ###    #  ## # #       # # #    #    E #
#   ##    ## #    # #  #  ##    #              # #    #   #   #      ###   ###                 #  ##
####################################################################################################