####################################################################################################
#S#       #         #       #             #             #     #       #     #   #             #   ##
# # # ### ##### ### # ##### # ####### ### ### # ####### # ### ### ### ### # # # ### ######### ### ##
# # # # #     #   # #     #   #     # # #   # # #   #   # # #     # #     # # #     #       #   # ##
# ### # ##### ### # ##### ##### ### # # ### ### # ### ### # ####### ####### # ####### ######### # ##
# #   #   #   #   # #       #   #   # #         #   #   # # #             #   # #   #     #     # ##
# # ##### # ### ##### ####### ### ### ########### # ### # # # ######### # ##### # # # ### # ##### ##
#   #     # # #   #   #   #   # #   #       #     #   #   #     #   #   #       # # #   #   #   # ##
##### ### # # # # # ##### # ### ### # ##### ####### # ### ####### # # ######### # # ### ##### # # ##
#       # # # # # # #     # #       #     # #     # #   # #       # #         # # #     #     # # ##
# ##### ### # # # # # ### # # ########### # # ### # ### # # ####### # ####### # # ####### # ### # ##
#     #     #   #   #   # # #   #       # #   #   #   #   #   #   # # #   #   # # #     # #   # # ##
##### ########### ##### # # ### # ##### # ##### ############# # # # # # # # ##### # ### ##### # # ##
#     #     #   #       # # # # #   #   # #   #     #       # # # # #   # #     # # #         # # ##
# ##### # # # # ######### # # # ### # ### ### ##### # ##### # # ### ##### ##### # # ########### # ##
# #   # # # # #     #   # # # # #   #   #   #     #   #   # #   #   #   #   # #   #   # #   #   # ##
# # # # # # # ##### # ### # # # # ##### ### ##### ##### # # ### # ### # ### # ####### # # # # ### ##
# # #   # #   #     #     # #   # #   # #       #     # # #     # # # #     #         # # # #   # ##
# # ##### ##### ####### ### # ### # # # ####### # ### ### ####### # # ##### ### ####### # # ### # ##
# # # #   #   #   #   # #   #     # # #     # # # #         #   # #   #   #     #   #     #     # ##
# # # # # # # ### # # # # ######### ####### # # # ######### # # # ##### # ####### # # ########### ##
# #   # # # #   #   # # # # #     #       # #   # #     #   # # #       #   #   # # #   #         ##
# ### # ### ### ##### ### # # ### # ### # # ### # # ### # ### # ########### # # # # ### ####### # ##
#   # #     # #     #     # # # #   # # # #   # #     # #     #         #   # #   #   # #       # ##
### # ####### ##### ####### # # ##### # # ### # ##### # ### ########### # ##### ##### # # ####### ##
# # #             # #       #         # #   # #   #   # #   #   #     # # #   # #     #   #     # ##
# # ##### ######### ####### ######### # ### # ### # ### ##### # # ### # # # # ### ######### ### # ##
# #   #   #       # #     #   #     # #   # # # # #   # #     #   # # # #   #   #         # # #   ##
# ### ##### ##### # # ### # ### # # # ### ### # # ##### # ######### # ##### ### # ####### # # ######
# #   #     #   #   # #     #   # # #   #     #   #     #   #   #   # #   #   # #       # # #     ##
# # ### ##### # ##### ####### ### # ### ####### ### ##### # # # ### # # # ##### ######### # # ### ##
#   #   #     #       #         # # # # #     #   # #   # #   # #   #   #   #   #         # # #   ##
# ### ####### ### ##### ######### # # # # # ##### # # # ### ### # ######### # ### ####### # # # ####
# #   #       #   #   #   #       #   # # #   #     # #   #   # # #       #   #       #   #   #   ##
# # ##### ######### # ### # ########### # ### # ##### ### ##### # # # ### ##### ##### ########### ##
# #     #   #     # #   # # #         # #   #   #   # # # #     #   #   # #     #   #     #     # ##
# ##### # # # ### # # ### # # ####### # ######### # # # # # ##### ##### ### ####### ##### # ### # ##
#       # #     #   #     #         #             #   #     #         #                 #     #  E##
####################################################################################################
####################################################################################################
