####################################################################################################
#S#             #       #           #   #     #       #     #   #           #       # #         # ##
# ### # ####### # ####### ### ##### # # # # # ### ### # ### # # # ##### # ### # ### # # # ##### # ##
#   # #   #   #         #   # #       # # # #   #   #   #   # #     #   # #   #   #   # # #   #   ##
# # ##### # # # ####### # ### ########### # ### ####### # # # ####### ##### ##### ### # # # # ######
# # #       # # #     #       #           # # #       # # # #   #     #     #     #   # #   #     ##
# # # ##### # # # ### ##### # # ########### # ####### ### ### ### # ### ##### ######### ####### # ##
# #   #   # #   # # #     # # # #   #   #   #     #   #   #   #   # #   #   # #     #     #   # # ##
# ##### # # ##### # ##### # ### # # # ### ##### # # ### ### ### # ### ### # # # ### # ##### # ### ##
#     # #   #   # #     # #       #   #   #     # #   # #   # # # #   # # #   # # #     #   #   # ##
# ### # ##### # # # ### # ############# ##### ### ### # # ### # ### ### # ##### # ####### ##### # ##
#   # #   #   #   # # # #             #     # #   #   # #     #     #   #   #   #   # #   #   #   ##
# # # ### # # ##### # # ############# # ### # ##### ### ##### ######### ### # ### # # # ### # ### ##
# # #   # # #     #   #       #     # #   # #       #       #         #   #   #   # # # #   #   # ##
# # ##### # ##### ### # ##### # ### # ### # # ####### # ############# ### ####### # # # # ##### # ##
# #       #     # # # # #   #   # # #   # # # #     # #             #       #     #   #       # # ##
# ### ########### # # # # # ##### # ### # # # # ##### ############# ####### ### ############# # ####
# #               # # #   # #     # #   # # # #             #     #       # #   #     #   #   #   ##
# ######### ####### # ##### ### # # # ##### # # ############# ### ### # ### # # # ### # # ### ### ##
#     #     #       #   # #   # #   # #     # # # #           # #   # #       # #   #   #   # #   ##
##### # ##### ##### ### # ### ##### # ### ### # # # ########### ### ########### ### ####### # # # ##
#       #   #   # #   #     #     # #     # # #   #   #           #           #   # #     # # # # ##
# # ####### ### # ### ##### ##### # ####### # ### ### ### ### # ############# # ### # ### # # # ####
# #           # #   #     #     # #       #   #     #   #   # # #         #   # #   # #   # # #   ##
# ####### ### # # # # ### ### ### ######### ####### ### # ### # # ### ### # ##### ### ##### ##### ##
# # #     # # # # # #   # #   #   #   #   #   #   #   # # #   # # # #   # # #     # #     #     # ##
# # # ##### # # # ##### # # ### ### # # # ### # # ### # # # ### # # ### # # # ##### # ### ##### # ##
#   # # #     # #   #   # #   #   # #   #   #   # #   # # #   # #     # # # # #   #   #     # # # ##
### # # # ##### ### # ### ### ### # # ##### ##### ##### # ### # ### ### # # # # ### ### ### # # # ##
# # # # # #   #   # # #     # # # # # #     #     #     #   # #   # #   # #   # #   # #   #   #   ##
# # # # # # # ### # # ##### # # # # # # ##### ##### ####### # ##### # ##### ### # ### ### ####### ##
#   # # #   # #   # #     # #   #   # #       #     #     # #     # #       #   #   #   #       # ##
# ### # # ##### ### ##### ##### ##### ######### ##### # ### ##### # ####### # # ### # # ##### ### ##
#   # #   #     #       #     # #                 #   #   # #     # #     #   #     # #     #     ##
##### ##### ######### # ### # # ################# ####### # # ### # ##### ####### ### ##### ##### ##
#     #   #   #     # #   # # #     #     #     #       #   #   # #   #   #     #         # #   # ##
# ##### # ### # ### ##### # ####### # ### # ### ####### # ##### ##### # # ### # ######### # # # # ##
#       #       #         #           #     #           #     #         #     #           #   #  E##
####################################################################################################
####################################################################################################
